#######################################################
#######################################################
#######################################################
#######################################################
#######################################################
#######################################################
#######################################################
#######################################################
#######################################################
#######################################################
#######################################################
#######################################################
#######################################################
#######################################################
#######################################################
#######################################################
#######################################################
#######################################################
#######################################################
#######################################################
#######################################################
#######################################################
@@@@@@@@@@@@@@@@@@@@@@@@@@@@@@@@@@@@@@@@@@@@@@@@@@@@@@@
@@@@@@@@@@@@@@@@@@@@@@@@@@@@@@@@@@@@@@@@@@@@@@@@@@@@@@@
1@@@@@@@@@@@@@@@@@@@@@@@@@@@@@@@@@@@@@@@@@@@@@@@@@@@@@0
@@@@@@@@@@@@@@@@@@@@@@@@@@@@@@@@@@@@@@@@@@@@@@@@@@@@@@@
@@@@@@@@@@@@@@@@@@@@@@@@@@@@@@@@@@@@@@@@@@@@@@@@@@@@@@@
#######################################################
#######################################################
#######################################################
#######################################################
#######################################################
#######################################################
#######################################################
#######################################################
#######################################################
#######################################################
#######################################################
#######################################################
#######################################################
#######################################################
#######################################################
#######################################################
#######################################################
#######################################################
#######################################################
#######################################################
#######################################################
#######################################################
#######################################################
#######################################################
#######################################################
#######################################################
#######################################################
#######################################################