#######################################################
#######################################################
#######################################################
#######################################################
#######################################################
#########################@@@@@@@@@@@@@@@@@@@@@@@@@@@@@@
#########################@@@@@@@@@@@@@@@@@@@@@@@@@@@@@@
#########################@@@@@@@@@@@@@@@@@@@@@@@@@@@@@@
#########################@@@@@@@@@@@@@@@@@@@@@@@@@@@@@@
#########################@@@@@@@@@@@@@@@@@@@@@@@@@@@@@@
#########################@@@@@####################@@@@@
#########################@@@@@####################@@@@@
#########################@@@@@####################@@@@@
#########################@@@@@####################@@@@@
#########################@@@@@####################@@@@@
#########################@@@@@####################@@@@@
#########################@@@@@####################@@@@@
#########################@@@@@####################@@@@@
#########################@@@@@####################@@@@@
#########################@@@@@####################@@@@@
#########################@@@@@####################@@@@@
#########################@@@@@####################@@@@@
@@@@@@@@@@@@@@@@@@@@@@@@@@@@@@####################@@@@@
@@@@@@@@@@@@@@@@@@@@@@@@@@@@@@####################@@@@@
1@@@@@@@@@@@@@@@@@@@@@@@@@@@@@####################@@@@0
@@@@@@@@@@@@@@@@@@@@@@@@@@@@@@####################@@@@@
@@@@@@@@@@@@@@@@@@@@@@@@@@@@@@####################@@@@@
#########################@@@@@####################@@@@@
#########################@@@@@####################@@@@@
#########################@@@@@####################@@@@@
#########################@@@@@####################@@@@@
#########################@@@@@####################@@@@@
#########################@@@@@@@@@@@@@@@@@@@@@@@@@@@@@@
#########################@@@@@@@@@@@@@@@@@@@@@@@@@@@@@@
#########################@@@@@@@@@@@@@@@@@@@@@@@@@@@@@@
#########################@@@@@@@@@@@@@@@@@@@@@@@@@@@@@@
#########################@@@@@@@@@@@@@@@@@@@@@@@@@@@@@@
#######################################################
#######################################################
#######################################################
#######################################################
#######################################################
#######################################################
#######################################################
#######################################################
#######################################################
#######################################################
#######################################################
#######################################################
#######################################################
#######################################################
#######################################################
#######################################################
#######################################################
#######################################################